WWWWWWWWWWWWWWWWWWWW
W----------W-F--W--W
W----------W----W--W
W----------WWBWWW--W
W---WTW------------W
W---W-WWW------P---W
W---WFFFWP---------W
W---W-P-W----------W
W---WWWWW----------W
W------------------W
W-----H----WWWWWW--W
W----------W-F--W--W
W----------W--F-W--W
W-------V-PL----W--W
W----------WWWWWW--W
W------------------W
WWWWWWWW-----------W
W------R-----------W
W-FF---W-----------W
WWWWWWWWWWWWWWWWWWWW