----------
----------
--WWWWWW--
--W----W--
--W--WWW--
--W--W----
--W--W----
--WWBW----
----------
----FP----